11                                                     111111
11   11111                          1111               111111
11     11111              3333                         111111
11        111111111111       11111                     111111
11                                                11111111111
11                                                   11111111
11                                                     111111
11                                                     111111
11 1111111    1  1  1  1  1  1  1  1   11              111111
11                                                     111111
11                                                     111111
11   1                                                 111111
11     1                                               111111
11       1        1111                                 111111
11         1      1111                                 111111
11                                                     111111
11                                                     111111
11                                                     111111
11                                                     111111
11                2     2                              111111
11                                                     111111
11                                                     111111
11                                                     111111
11  11                                                 111111
11     333333     11111111111                          111111
11                                                         11
11                                                         11
11                                              1111111111111
1D                                              11fffff111111
1D                                hhhhh         11FFFFF111111
1111111111111111111111111111111111111111111111111111111111111
1111111111111111111111111111111111111111111111111111111111111