11                                                     11
11   11111                          1111               11
11     11111              3333                         11
11        111111111111       11111                     11
11                                                1111111
11                                                   1111
11                                                     11
11                                                     11
11 1111111    1  1  1  1  1  1  1  1   11              11
11                                                     11
11                                       h             11
11   1                                    h            11
11     1                                   h           11
11       1        1111                      h          11
11         1      1111                       h         11
11                                            h        11
11                                             h       11
11                                              h      11
11                                               h     11
11                2     2                         h    11
11                                                 h   11
11                                                  h  11
11                                                   h 11
11  11                                                h11
11     333333     11111111111                          11
11                                                     11
11                                                     11
11                                    eeeeeeeeeeeeeeeee11
1D        PPPPPPPPPPPPPP              D<ffffffffffffff>11
1D                                    D(FFFFFFFFFFFFFF)11
111111111111111111111111111111111111111111111111111111111
111111111111111111111111111111111111111111111111111111111