11                                                     1111111111
11   11111                          1111               11..111111
11     11111              3333                         11...11111
11        111111111111       11111                     11...11111
11                                                1111111...11111
11                                                   1111...11111
11                                                     11...11111
11                                                     11...11111
11 1111111    1  1  1  1  1  1  1  1   11              11...11111
11                                                     11...11111
11                                                     11...11111
11   1                                                 11...11111
11     1                                               11...11111
11       1        1111                                 11........
11         1      1111                                 11...11111
11                                                     11...11111
11                                       hhh           11...11111
11           3                                         11...11111
11                                                     11...11111
11     1          2     2                              11...11111
11                                                     11...11111
11            1     2     11      111                  11...11111
11                                                     11...11111
11  11                                  111            11...11111
11     333333     11111111111                          11...11111
11                                PPPPPP               11...11111
11     PPP                     PPPPPPPPPP             h11...11111
11                      PPPPPPPPPPPPPP          111111111...11111
1D                    PPPPPPPPPPPPPP            11fffff11...11111
1D                                              11FFFFF11...11111
111111111111111111111111111111111111111111111111111111111...11111
111111111111111111111111111111111111111111111111111111111...11111